m,10,10
p,5,5,10,255,100,100
s,1,1
d,7,2
c,5,5,david.txt,255,0,0
4,1,1,1,1,1,1,1,1,4,
1,1,1,1,1,1,1,1,1,1,
1,1,1,1,1,3,3,3,1,1,
1,1,1,1,1,3,3,3,1,1,
1,1,1,1,1,3,3,3,1,1,
1,1,1,1,1,1,1,1,1,1,
1,1,1,1,1,1,1,1,1,1,
1,1,1,1,1,1,1,1,1,1,
1,1,1,1,1,1,1,1,1,1,
4,1,1,1,1,1,1,1,1,4